LGA Code 2011,A10 Homicide and related offence,A20 Assault and related offences , A30 Sexual offences, A40 Abduction and related ofences , A50 Robbery,A60 Blackmail and extortion,"A70 Stalking, harassment and threatening behaviour",A80 Dangerous and negligent acts endangering people,Total offence count: (A),B10 Arson,B20 Property Damage,B30 Burglary/Break and enter,B40 Theft,B50 Deception,B60 Bribery,Total offence count: (B),C10 Drug dealing and trafficking,C20 Cultivate or manufacture drugs,C30 Drug use and possesion ,C90 Other drug offences,Total offence count: (C),D10 Weapons and explosives offence,D20 Disorderly and offensive conduct,D30 Public nuisance offences,D40 Public security offences,Total offence count: (D),E10 Justice procedures,E20 Breaches of orders,Total (E) Justice procedures offences,F10 Regulatory driving offences,F20 Transport regulation offences,F30 Other government regulatory off,F90 Miscellaneous offences,Total (F) Other offences,Grand Total Offences,LGA Estimated Residential Population,LGA Name,Reference Period,Victoria Estimated Residential Population
20110,0,37,20,1,1,0,11,9,79,4,57,35,114,19,0,229,3,6,18,0,27,17,47,13,0,77,5,23,28,0,1,0,2,3,443,12109,Alpine (S),2012,5632521
20110,3,39,13,0,0,0,14,11,77,3,63,42,109,8,0,225,3,8,25,0,36,42,64,2,0,108,6,31,37,0,0,1,3,4,487,12030,Alpine (S),2013,5733545
20110,3,46,38,0,0,0,11,3,98,7,46,24,211,29,0,317,3,4,32,0,39,41,44,5,0,90,9,22,31,1,0,2,14,17,592,12019,Alpine (S),2014,5838110
20110,0,47,26,1,0,0,4,17,95,6,52,28,108,25,0,219,7,9,30,0,46,37,58,6,0,101,6,37,43,0,2,4,2,8,512,11858,Alpine (S),2015,5937481
20110,0,55,29,0,0,0,17,4,105,2,41,34,97,14,0,188,10,3,23,1,37,31,42,3,0,76,2,45,47,0,1,2,0,3,456,11985,Alpine (S),2016,6053355
20260,0,162,45,2,1,0,36,17,263,18,192,76,275,16,0,577,7,1,30,0,38,34,106,37,0,177,34,50,84,0,0,4,10,14,1153,11335,Ararat (RC),2012,5632521
20260,3,179,39,1,1,0,31,19,270,23,202,78,208,23,0,534,210,3,50,0,263,35,114,16,0,165,55,86,141,0,0,10,1,11,1384,11214,Ararat (RC),2013,5733545
20260,3,203,57,0,0,0,28,28,316,16,147,64,178,25,0,430,1,1,32,0,34,45,108,10,0,163,49,112,161,0,1,6,1,8,1112,11139,Ararat (RC),2014,5838110
20260,0,200,59,0,0,0,43,21,323,20,172,66,178,52,0,488,29,3,66,0,98,30,114,15,0,159,42,127,169,0,0,3,5,8,1245,11028,Ararat (RC),2015,5937481
20260,3,256,42,1,2,0,41,21,363,14,145,68,184,52,0,463,15,4,122,1,142,48,89,16,0,153,84,196,280,0,0,0,4,4,1405,11299,Ararat (RC),2016,6053355
20570,3,1032,238,46,30,4,263,89,1702,106,1862,1166,3127,333,1,6595,43,19,162,1,225,162,355,43,3,563,143,546,689,0,1,15,6,22,9796,96935,Ballarat (C),2012,5632521
20570,5,893,269,15,35,0,234,94,1545,86,1541,1237,3313,489,0,6666,65,28,249,13,355,289,424,24,1,738,159,599,758,0,0,5,3,8,10070,98570,Ballarat (C),2013,5733545
20570,0,857,443,11,29,5,141,98,1584,52,1340,1061,3029,565,0,6047,65,21,408,0,494,340,469,44,0,853,118,1031,1149,1,1,7,3,12,10139,100240,Ballarat (C),2014,5838110
20570,3,837,531,14,25,7,149,87,1650,125,1338,1288,3694,479,0,6924,89,55,410,1,555,289,352,45,0,686,197,1278,1475,0,5,34,10,49,11339,101578,Ballarat (C),2015,5937481
20570,5,947,555,12,38,2,134,130,1823,168,1220,1269,4163,700,0,7520,57,48,400,2,507,350,284,41,1,676,435,1221,1656,1,8,20,3,32,12214,104344,Ballarat (C),2016,6053355
20660,3,656,150,15,59,2,252,70,1204,54,889,978,2169,262,0,4352,46,31,267,0,344,117,158,38,1,314,115,987,1102,0,10,9,6,25,7341,123600,Banyule (C),2012,5632521
20660,3,620,178,9,47,2,250,81,1187,45,839,953,3197,383,0,5417,34,12,252,0,298,167,273,43,2,485,142,1170,1312,2,2,4,5,13,8712,124350,Banyule (C),2013,5733545
20660,4,573,251,10,51,7,213,59,1168,35,795,1114,2748,444,0,5136,34,9,229,0,272,125,174,37,3,339,115,1484,1599,1,14,15,8,38,8552,125451,Banyule (C),2014,5838110
20660,0,658,237,14,30,0,227,55,1221,47,775,908,2860,472,0,5062,61,20,391,0,472,221,173,68,0,462,191,1771,1962,0,5,5,12,22,9201,126232,Banyule (C),2015,5937481
20660,3,711,169,12,35,7,224,71,1229,58,778,1149,3422,676,0,6083,90,29,342,0,461,199,160,55,2,416,212,1253,1465,1,5,4,3,13,9667,127430,Banyule (C),2016,6053355
20740,3,254,74,1,4,0,84,26,443,18,266,220,565,44,0,1113,25,11,82,0,118,33,156,9,0,198,21,105,126,0,3,23,5,31,2029,30616,Bass Coast (S),2012,5632521
20740,3,282,110,2,1,0,129,22,546,21,255,205,518,67,0,1066,20,18,106,0,144,60,141,22,0,223,19,162,181,0,2,10,2,14,2174,30975,Bass Coast (S),2013,5733545
20740,3,349,117,8,4,1,116,30,625,25,322,272,582,72,0,1273,29,21,100,0,150,80,175,21,0,276,49,265,314,0,0,1,2,3,2641,31610,Bass Coast (S),2014,5838110
20740,3,285,149,3,6,0,115,40,598,32,268,187,483,86,0,1056,28,18,164,0,210,74,119,23,0,216,38,379,417,1,6,5,6,18,2515,32033,Bass Coast (S),2015,5937481
20740,0,335,113,6,3,0,96,54,607,37,301,191,701,113,0,1343,20,9,95,0,124,88,99,25,0,212,101,454,555,0,6,4,0,10,2851,33581,Bass Coast (S),2016,6053355
20830,0,310,64,2,8,0,90,40,514,29,370,238,793,68,0,1498,19,6,95,0,120,76,151,7,0,234,47,98,145,0,3,2,1,6,2517,44296,Baw Baw (S),2012,5632521
20830,3,263,106,4,1,0,115,44,533,50,333,287,802,290,0,1762,40,17,165,0,222,185,166,16,0,367,38,205,243,0,18,8,13,39,3166,45158,Baw Baw (S),2013,5733545
20830,3,342,138,5,12,0,169,42,708,46,341,259,712,600,0,1958,77,13,168,0,258,112,202,23,0,337,52,360,412,0,18,6,15,39,3712,45912,Baw Baw (S),2014,5838110
20830,0,329,183,3,9,0,165,35,724,37,308,234,827,150,0,1556,85,19,243,0,347,178,117,15,0,310,50,482,532,0,12,7,3,22,3491,46638,Baw Baw (S),2015,5937481
20830,3,358,220,7,9,0,143,51,788,41,353,297,1052,166,0,1909,90,14,324,0,428,166,83,35,0,284,105,509,614,0,11,4,24,39,4062,48378,Baw Baw (S),2016,6053355
20910,3,229,46,1,19,5,100,22,422,12,595,696,1693,414,0,3410,9,4,111,0,124,61,92,14,0,167,86,146,232,0,0,0,0,0,4355,96992,Bayside (C),2012,5632521
20910,3,223,81,3,18,3,90,14,432,13,593,666,1423,193,0,2888,48,8,163,0,219,96,141,16,0,253,48,227,275,1,6,3,2,12,4079,98270,Bayside (C),2013,5733545
20910,3,246,84,0,24,2,97,33,486,18,458,570,1462,284,0,2792,37,14,244,3,298,107,137,21,0,265,25,284,309,1,7,2,3,13,4163,99914,Bayside (C),2014,5838110
20910,3,254,175,11,23,2,70,34,569,15,442,611,1558,178,0,2804,25,11,267,1,304,138,156,24,0,318,25,302,327,0,7,1,1,9,4331,101321,Bayside (C),2015,5937481
20910,3,310,129,6,33,1,105,29,613,22,481,595,2193,403,0,3694,17,12,190,0,219,131,125,38,0,294,80,370,450,0,10,3,1,14,5284,101852,Bayside (C),2016,6053355
21010,0,120,27,2,1,0,23,12,185,19,144,67,239,18,1,488,4,14,51,0,69,31,52,7,0,90,17,64,81,0,5,1,1,7,920,13731,Benalla (RC),2012,5632521
21010,0,163,67,1,1,1,38,16,287,26,165,87,212,27,1,518,4,5,54,0,63,45,40,10,0,95,20,82,102,1,7,1,2,11,1076,13697,Benalla (RC),2013,5733545
21010,0,168,92,1,1,0,44,27,333,23,174,79,225,9,0,510,6,8,58,0,72,37,57,9,0,103,27,168,195,0,0,3,4,7,1220,13603,Benalla (RC),2014,5838110
21010,3,154,36,1,3,0,32,35,261,34,167,55,146,24,0,426,7,7,38,0,52,32,28,17,0,77,15,201,216,0,1,4,1,6,1038,13496,Benalla (RC),2015,5937481
21010,0,190,85,2,4,0,33,21,335,18,186,94,262,206,0,766,11,4,54,0,69,35,17,19,0,71,32,289,321,0,2,7,4,13,1575,13715,Benalla (RC),2016,6053355
21110,0,346,129,12,57,3,77,42,666,29,1014,1185,2673,286,0,5187,33,22,227,2,284,92,236,40,0,368,42,161,203,0,10,19,6,35,6743,168458,Boroondara (C),2012,5632521
21110,3,354,129,9,39,3,148,28,710,37,918,1317,2693,484,0,5449,35,10,248,0,293,117,259,21,2,399,30,199,229,0,2,12,9,23,7103,170382,Boroondara (C),2013,5733545
21110,3,321,169,8,33,1,118,31,681,40,716,1358,2713,434,0,5261,45,22,317,0,384,106,224,34,1,365,40,266,306,0,0,14,2,16,7013,172551,Boroondara (C),2014,5838110
21110,3,368,123,8,30,2,104,42,677,12,577,1341,2781,396,1,5108,36,12,257,0,305,113,163,30,5,311,37,258,295,0,6,14,1,21,6717,174787,Boroondara (C),2015,5937481
21110,3,414,160,6,38,2,141,47,808,22,599,1191,3835,804,0,6451,31,12,306,0,349,120,171,30,1,322,134,600,734,0,4,4,3,11,8675,177915,Boroondara (C),2016,6053355
21180,5,1377,258,40,247,6,304,148,2385,167,1726,2357,7398,785,1,12434,236,113,740,1,1090,470,315,57,0,842,208,1009,1217,0,11,3,19,33,18001,193334,Brimbank (C),2012,5632521
21180,12,1411,299,34,306,7,341,134,2544,167,1610,2306,7387,1263,1,12734,298,116,845,0,1259,589,486,62,2,1139,263,1491,1754,0,11,15,9,35,19465,195273,Brimbank (C),2013,5733545
21180,13,1305,319,28,214,7,371,145,2402,92,1408,1895,5990,1212,0,10597,273,139,798,1,1211,566,423,73,1,1063,229,1999,2228,1,10,17,6,34,17535,197637,Brimbank (C),2014,5838110
21180,11,1422,228,18,156,4,405,171,2415,118,1469,1997,6632,1061,0,11277,357,135,1055,0,1547,770,365,71,2,1208,289,1829,2118,1,10,10,5,26,18591,199432,Brimbank (C),2015,5937481
21180,8,1542,233,23,200,4,386,159,2555,129,1484,2021,6978,965,0,11577,322,105,1102,0,1529,821,321,78,1,1221,473,2111,2584,0,17,5,4,26,19492,200144,Brimbank (C),2016,6053355
21270,0,27,16,0,0,0,5,3,51,3,58,34,92,2,0,189,1,1,4,0,6,13,27,11,0,51,3,2,5,0,0,1,0,1,303,6355,Buloke (S),2012,5632521
21270,0,25,5,0,0,0,7,5,42,2,32,23,80,8,0,145,3,1,4,0,8,15,7,8,0,30,2,7,9,0,0,7,2,9,243,6214,Buloke (S),2013,5733545
21270,0,21,10,0,0,0,8,6,45,1,31,24,55,6,0,117,3,2,5,0,10,7,13,2,0,22,1,2,3,0,0,3,0,3,200,6084,Buloke (S),2014,5838110
21270,3,22,25,0,0,0,4,2,53,1,15,43,77,2,0,138,0,1,3,0,4,7,12,4,0,23,1,5,6,0,1,0,2,3,227,5952,Buloke (S),2015,5937481
21270,0,20,23,0,0,0,7,7,57,0,32,25,61,4,0,122,3,2,14,0,19,5,3,1,0,9,3,10,13,0,0,2,1,3,223,5966,Buloke (S),2016,6053355
21370,3,185,98,4,6,0,22,18,333,20,354,321,866,43,0,1604,9,9,66,0,84,44,248,18,0,310,34,126,160,0,1,4,5,10,2501,36967,Campaspe (S),2012,5632521
21370,3,286,81,4,9,0,52,20,452,43,334,337,878,71,0,1663,18,9,55,0,82,64,174,16,0,254,34,168,202,0,1,7,7,15,2668,36898,Campaspe (S),2013,5733545
21370,4,236,121,3,9,0,37,41,451,40,301,314,969,58,0,1682,20,7,68,0,95,74,194,9,0,277,37,273,310,0,2,0,2,4,2819,36889,Campaspe (S),2014,5838110
21370,0,294,93,3,4,1,81,25,501,25,264,433,867,95,0,1684,28,11,105,0,144,83,160,16,0,259,58,343,401,1,0,4,12,17,3006,36747,Campaspe (S),2015,5937481
21370,3,347,230,12,9,3,115,49,765,38,341,336,936,99,0,1750,25,13,125,0,163,156,139,23,0,318,175,518,693,0,1,5,13,19,3708,36955,Campaspe (S),2016,6053355
21450,6,488,158,10,19,1,161,60,903,50,640,612,1522,232,0,3056,34,26,179,2,241,168,126,26,1,321,34,228,262,0,2,4,6,12,4795,80188,Cardinia (S),2012,5632521
21450,5,564,122,5,19,5,290,71,1081,90,727,660,1755,264,0,3496,34,18,189,1,242,160,132,28,1,321,60,630,690,1,3,2,16,22,5852,83980,Cardinia (S),2013,5733545
21450,5,483,111,16,27,4,179,61,886,63,654,517,1688,388,0,3310,50,22,296,0,368,225,128,22,1,376,73,561,634,0,12,18,24,54,5628,87034,Cardinia (S),2014,5838110
21450,6,530,184,22,16,3,274,68,1103,64,619,530,2117,323,1,3654,65,23,348,0,436,319,138,39,0,496,80,1103,1183,0,5,16,11,32,6904,90884,Cardinia (S),2015,5937481
21450,3,620,208,17,33,8,176,93,1155,106,641,800,2200,335,0,4082,39,16,319,0,374,192,121,51,23,387,246,1277,1523,0,10,4,6,20,7541,95604,Cardinia (S),2016,6053355
21610,8,1663,322,26,142,15,440,177,2793,202,1765,1601,4689,615,0,8872,166,62,547,0,775,352,385,40,3,780,143,904,1047,1,7,10,8,26,14293,267640,Casey (C),2012,5632521
21610,3,1771,396,43,97,12,450,168,2937,231,1736,1665,4954,924,0,9510,165,92,619,0,876,432,352,78,6,868,158,1008,1166,1,6,20,10,37,15394,274836,Casey (C),2013,5733545
21610,10,1790,419,36,89,10,497,218,3069,185,1704,1695,5528,1166,0,10278,166,86,720,0,972,486,344,81,10,921,183,1639,1822,1,21,5,14,41,17103,283215,Casey (C),2014,5838110
21610,5,1786,600,28,123,16,623,238,3419,145,1769,1992,6665,1084,0,11655,198,113,900,0,1211,785,322,73,7,1187,212,2264,2476,1,18,16,7,42,19990,292211,Casey (C),2015,5937481
21610,7,2183,520,49,191,13,780,249,3992,217,1734,2647,7962,1529,0,14089,151,56,907,0,1114,575,283,80,6,944,672,2542,3214,0,19,6,7,32,23385,300169,Casey (C),2016,6053355
21670,0,101,29,1,2,0,34,10,177,8,152,66,202,51,0,479,1,4,31,0,36,27,75,9,0,111,17,49,66,0,1,4,0,5,874,12581,Central Goldfields (S),2012,5632521
21670,0,143,58,0,0,0,57,16,274,19,183,73,180,30,0,485,8,4,25,0,37,55,77,10,0,142,33,82,115,0,0,4,3,7,1060,12620,Central Goldfields (S),2013,5733545
21670,0,131,57,2,4,1,41,18,254,19,153,82,204,35,0,493,2,5,25,0,32,44,73,14,0,131,22,170,192,0,0,1,7,8,1110,12609,Central Goldfields (S),2014,5838110
21670,0,127,61,3,2,0,27,14,234,14,129,111,229,31,0,514,10,2,52,0,64,67,54,29,0,150,20,205,225,0,0,1,1,2,1189,12575,Central Goldfields (S),2015,5937481
21670,0,156,55,2,5,1,49,10,278,27,125,97,334,61,0,644,10,15,34,0,59,91,32,13,0,136,58,355,413,0,0,0,2,2,1532,12729,Central Goldfields (S),2016,6053355
21750,3,169,74,1,3,0,43,15,305,10,186,168,364,33,0,761,2,10,46,0,58,32,141,15,0,188,40,50,90,0,0,3,16,19,1421,20767,Colac-Otway (S),2012,5632521
21750,0,153,58,0,6,0,47,9,273,11,163,122,305,37,0,638,11,6,53,2,72,42,101,9,0,152,30,76,106,0,1,4,24,29,1270,20666,Colac-Otway (S),2013,5733545
21750,3,198,87,2,4,0,46,17,354,8,196,144,369,81,0,798,14,4,46,0,64,61,80,20,0,161,14,141,155,0,2,0,12,14,1546,20504,Colac-Otway (S),2014,5838110
21750,3,190,72,0,4,0,109,18,393,7,143,152,347,45,0,694,9,3,52,0,64,60,81,14,0,155,35,163,198,0,0,0,6,6,1510,20255,Colac-Otway (S),2015,5937481
21750,0,183,56,4,2,2,62,16,325,9,185,121,496,114,0,925,27,11,103,0,141,78,64,10,0,152,60,191,251,0,7,6,7,20,1814,20676,Colac-Otway (S),2016,6053355
21830,4,59,20,0,2,1,12,15,113,3,98,132,194,120,0,547,1,3,21,0,25,28,17,6,0,51,3,47,50,0,1,1,1,3,789,16387,Corangamite (S),2012,5632521
21830,3,57,23,0,2,0,42,11,135,4,71,94,134,20,0,323,10,11,19,0,40,27,35,0,0,62,12,50,62,0,0,1,0,1,623,16108,Corangamite (S),2013,5733545
21830,3,84,47,2,2,0,8,29,172,4,58,81,171,22,0,336,5,13,19,0,37,25,30,5,0,60,9,42,51,0,1,2,3,6,662,15920,Corangamite (S),2014,5838110
21830,0,70,91,0,0,1,13,8,183,9,64,73,153,15,0,314,7,9,28,0,44,33,15,6,0,54,8,96,104,0,0,1,5,6,705,15671,Corangamite (S),2015,5937481
21830,0,82,41,2,1,0,22,13,161,5,101,116,237,43,0,502,7,3,30,0,40,36,18,6,1,61,10,91,101,0,1,1,0,2,867,15961,Corangamite (S),2016,6053355
21890,6,709,204,22,184,5,192,74,1396,94,1048,1753,5008,772,4,8679,91,34,394,0,519,186,275,71,3,535,128,363,491,0,5,2,32,39,11659,144641,Darebin (C),2012,5632521
21890,3,864,336,21,126,5,233,73,1658,90,1032,1833,4270,763,1,7989,81,30,392,0,503,224,287,57,0,568,111,382,493,1,11,8,18,38,11249,146650,Darebin (C),2013,5733545
21890,3,921,172,23,111,4,327,108,1666,74,1126,1910,5994,1127,0,10231,67,17,431,0,515,287,314,52,1,654,119,1145,1264,0,15,22,9,46,14376,148675,Darebin (C),2014,5838110
21890,5,797,249,24,81,3,350,125,1634,71,1108,1823,6548,1333,1,10884,103,34,596,0,733,395,283,56,9,743,136,923,1059,1,13,6,2,22,15075,150881,Darebin (C),2015,5937481
21890,3,888,197,15,78,3,266,144,1591,72,1117,1922,7349,1282,0,11742,139,40,731,0,910,397,298,56,0,751,398,896,1294,1,23,3,4,31,16319,153638,Darebin (C),2016,6053355
22110,3,416,79,3,6,0,66,18,588,35,523,330,795,58,0,1741,13,14,49,0,76,81,232,21,0,334,70,194,264,0,4,11,18,33,3036,43160,East Gippsland (S),2012,5632521
22110,3,541,57,6,8,0,129,56,797,55,598,298,1092,103,0,2146,11,24,90,0,125,118,192,27,2,339,67,382,449,0,3,10,6,19,3875,43376,East Gippsland (S),2013,5733545
22110,3,599,80,3,11,1,130,59,883,46,591,229,745,91,0,1702,23,42,134,0,199,128,246,37,0,411,76,581,657,2,4,12,7,25,3877,43678,East Gippsland (S),2014,5838110
22110,3,553,117,11,13,2,136,45,877,25,495,325,874,95,0,1814,71,39,180,3,293,217,251,27,0,495,71,515,586,2,9,15,10,36,4101,43995,East Gippsland (S),2015,5937481
22110,3,541,126,2,7,3,123,63,865,29,495,283,991,159,0,1957,57,21,195,0,273,162,170,55,0,387,122,641,763,2,1,4,11,18,4263,44611,East Gippsland (S),2016,6053355
22170,4,1213,298,24,84,4,234,121,1982,112,1526,1169,3879,693,0,7379,105,70,479,0,654,444,926,68,0,1438,282,1069,1351,0,26,24,11,61,12865,131754,Frankston (C),2012,5632521
22170,3,1178,277,18,68,3,263,138,1945,109,1556,994,4332,712,0,7703,169,48,681,7,905,828,1084,75,3,1990,369,1151,1520,0,7,15,7,29,14092,133425,Frankston (C),2013,5733545
22170,4,1080,336,19,104,0,284,148,1975,112,1297,919,4326,895,0,7549,204,55,799,0,1058,732,858,77,4,1671,395,1877,2272,2,9,18,18,47,14572,134899,Frankston (C),2014,5838110
22170,3,1104,407,20,77,3,307,170,2088,100,1347,994,4391,817,0,7649,272,50,778,3,1103,671,731,52,2,1456,337,2186,2523,0,6,18,13,37,14856,135971,Frankston (C),2015,5937481
22170,6,1239,363,24,106,2,300,207,2247,122,1305,1284,4802,1088,0,8601,182,51,924,0,1157,651,505,145,0,1301,620,2320,2940,0,10,8,10,28,16274,137554,Frankston (C),2016,6053355
22250,0,70,19,0,0,0,11,5,105,8,70,48,109,19,0,254,6,4,15,0,25,10,62,10,0,82,12,34,46,0,1,1,0,2,514,10376,Gannawarra (S),2012,5632521
22250,0,82,24,3,1,0,14,11,135,6,75,59,122,11,0,273,6,0,18,0,24,14,60,11,0,85,5,29,34,0,0,2,0,2,553,10311,Gannawarra (S),2013,5733545
22250,3,82,9,0,0,0,20,9,120,12,54,41,138,6,0,251,15,0,27,0,42,23,62,8,0,93,6,58,64,0,0,2,1,3,573,10142,Gannawarra (S),2014,5838110
22250,0,68,17,2,0,0,16,11,114,8,59,38,103,11,0,219,7,9,27,0,43,35,30,5,2,72,13,80,93,0,0,0,3,3,544,10019,Gannawarra (S),2015,5937481
22250,0,61,31,0,2,0,17,5,116,10,35,60,107,16,0,228,3,9,36,0,48,37,16,8,0,61,7,115,122,0,0,3,0,3,578,9771,Gannawarra (S),2016,6053355
22310,3,375,85,6,52,3,88,17,626,21,734,965,2131,349,1,4201,19,9,205,2,235,71,121,20,0,212,80,168,248,1,12,11,0,24,5546,139242,Glen Eira (C),2012,5632521
22310,0,379,119,7,42,2,106,14,669,19,704,827,2078,417,1,4046,29,14,203,0,246,97,180,15,0,292,56,270,326,0,7,5,3,15,5594,141379,Glen Eira (C),2013,5733545
22310,3,331,107,1,33,0,85,27,584,16,560,849,1900,465,0,3790,62,15,233,0,310,124,186,22,1,333,59,299,358,0,19,23,12,54,5429,144009,Glen Eira (C),2014,5838110
22310,3,343,123,8,33,1,130,39,677,36,525,830,2204,407,0,4002,60,14,319,0,393,138,164,27,1,330,43,330,373,0,6,2,3,11,5786,146303,Glen Eira (C),2015,5937481
22310,3,501,186,4,59,2,109,49,910,30,647,871,2546,460,1,4555,72,13,403,2,490,178,230,55,1,464,84,779,863,0,17,4,1,22,7304,148050,Glen Eira (C),2016,6053355
22410,3,130,22,0,4,0,14,23,193,15,222,163,371,49,0,820,11,6,38,0,55,46,80,12,0,138,40,41,81,1,1,2,2,6,1293,19758,Glenelg (S),2012,5632521
22410,3,148,28,0,1,0,20,19,216,15,229,107,414,21,0,786,11,7,63,0,81,56,88,20,0,164,25,123,148,0,1,2,4,7,1402,19500,Glenelg (S),2013,5733545
22410,0,156,75,2,2,1,28,36,300,19,225,147,445,44,0,880,9,7,78,0,94,64,82,51,0,197,29,159,188,0,3,4,3,10,1669,19355,Glenelg (S),2014,5838110
22410,3,150,118,0,3,0,29,20,320,15,271,124,362,32,0,804,18,6,123,0,147,84,81,17,0,182,57,203,260,1,0,4,5,10,1723,19158,Glenelg (S),2015,5937481
22410,3,168,76,1,1,0,37,11,294,12,259,123,433,31,0,858,18,8,62,0,88,47,50,29,0,126,52,194,246,0,2,1,1,4,1616,19283,Glenelg (S),2016,6053355
22490,0,27,19,0,1,0,7,17,71,4,50,95,122,4,0,275,4,3,6,0,13,6,8,1,0,15,1,17,18,0,0,0,1,1,393,19470,Golden Plains (S),2012,5632521
22490,0,43,26,0,0,0,8,11,88,12,37,81,119,5,0,254,1,0,7,0,8,11,12,17,0,40,6,11,17,1,0,3,1,5,412,20131,Golden Plains (S),2013,5733545
22490,3,42,16,0,0,0,15,5,78,8,31,115,153,12,0,319,3,7,4,0,14,17,13,0,0,30,3,13,16,0,0,0,1,1,458,20538,Golden Plains (S),2014,5838110
22490,3,49,15,1,0,1,8,6,80,17,39,123,209,14,0,402,4,3,12,0,19,12,5,17,1,35,9,46,55,0,1,0,2,3,594,20809,Golden Plains (S),2015,5937481
22490,0,58,16,0,1,0,15,15,105,40,57,138,249,25,0,509,7,3,16,0,26,3,6,14,0,23,14,48,62,0,0,7,4,11,736,21714,Golden Plains (S),2016,6053355
22620,3,678,249,10,30,4,160,56,1187,89,1021,655,2078,134,0,3977,45,21,174,0,240,152,401,117,0,670,128,666,794,0,2,31,6,39,6907,103605,Greater Bendigo (C),2012,5632521
22620,3,772,262,10,23,1,216,64,1348,106,967,537,2000,984,0,4594,74,32,227,0,333,219,547,51,0,817,155,1197,1352,0,9,13,5,27,8471,105222,Greater Bendigo (C),2013,5733545
22620,3,764,312,12,20,1,185,79,1373,90,914,596,2152,591,0,4343,124,50,409,3,586,275,503,79,1,858,148,1186,1334,0,7,10,6,23,8517,107051,Greater Bendigo (C),2014,5838110
22620,5,777,242,15,20,0,310,100,1469,78,810,700,2184,274,12,4058,125,23,365,0,513,285,465,75,1,826,159,1274,1433,1,2,11,10,24,8323,108437,Greater Bendigo (C),2015,5937481
22620,8,739,286,12,30,0,356,128,1559,115,875,807,2933,418,0,5148,102,19,368,0,489,342,366,67,0,775,439,1782,2221,0,1,10,7,18,10210,110497,Greater Bendigo (C),2016,6053355
22670,8,1353,401,33,140,10,340,114,2399,82,1239,1487,4414,967,0,8189,166,50,753,0,969,477,961,64,21,1523,368,1161,1529,0,22,35,11,68,14677,144312,Greater Dandenong (C),2012,5632521
22670,5,1513,373,36,119,12,325,126,2509,111,1312,1611,4892,1046,0,8972,181,79,793,0,1053,607,943,85,1,1636,298,1536,1834,0,10,31,21,62,16066,146578,Greater Dandenong (C),2013,5733545
22670,5,1584,430,31,129,12,471,163,2825,112,1245,1319,4456,1124,0,8256,192,48,882,2,1124,676,743,83,4,1506,318,1875,2193,1,32,40,8,81,15985,149466,Greater Dandenong (C),2014,5838110
22670,7,1532,405,37,161,8,402,193,2745,115,1277,1616,5860,1127,0,9995,232,84,1009,0,1325,741,748,96,1,1586,392,2753,3145,3,36,31,19,89,18885,152739,Greater Dandenong (C),2015,5937481
22670,5,1755,368,36,216,5,619,244,3248,105,1367,1927,6489,1233,0,11121,180,57,1106,1,1344,663,764,111,2,1540,679,2404,3083,1,37,15,3,56,20392,155913,Greater Dandenong (C),2016,6053355
22750,7,1287,274,13,109,1,295,100,2086,167,1973,2169,5986,478,1,10774,82,47,405,1,535,391,689,83,1,1164,178,829,1007,1,13,61,7,82,15648,218125,Greater Geelong (C),2012,5632521
22750,5,1523,456,31,63,4,347,137,2566,186,1905,2331,5811,791,0,11024,100,42,403,14,559,547,991,106,2,1646,138,1112,1250,0,1,16,10,27,17072,221290,Greater Geelong (C),2013,5733545
22750,3,1355,379,17,78,2,331,177,2339,190,2006,2238,6248,1040,0,11722,104,54,528,5,691,485,960,45,1,1491,195,1321,1516,0,6,13,5,24,17783,224906,Greater Geelong (C),2014,5838110
22750,4,1451,438,21,73,6,355,196,2544,165,1960,2310,7226,1694,9,13364,147,40,649,1,837,599,962,100,0,1661,341,1833,2174,2,7,16,10,35,20615,229420,Greater Geelong (C),2015,5937481
22750,8,1529,428,33,88,5,453,215,2759,240,2177,3197,9200,1216,0,16030,175,59,690,0,924,628,670,84,1,1383,555,2028,2583,1,22,15,8,46,23725,231487,Greater Geelong (C),2016,6053355
22830,3,565,152,9,22,3,86,48,885,55,919,658,1705,274,0,3611,61,23,344,0,428,220,430,32,0,682,98,410,508,1,3,14,2,20,6134,62379,Greater Shepparton (C),2012,5632521
22830,3,684,119,18,18,1,140,67,1047,89,889,709,1490,258,0,3435,79,30,416,3,528,295,355,38,0,688,87,484,571,2,6,8,4,20,6289,62707,Greater Shepparton (C),2013,5733545
22830,9,776,105,16,21,5,171,66,1169,101,880,816,1781,290,1,3869,49,19,335,0,403,217,347,49,0,613,131,852,983,0,1,2,2,5,7042,63131,Greater Shepparton (C),2014,5838110
22830,3,707,256,11,14,2,191,87,1268,103,696,873,1964,307,0,3943,61,18,387,0,466,295,272,41,1,609,135,1194,1329,0,0,9,5,14,7629,63366,Greater Shepparton (C),2015,5937481
22830,3,745,291,16,18,1,249,117,1437,78,769,889,2038,381,0,4155,68,22,371,0,461,278,285,54,4,621,253,1250,1503,0,1,10,5,16,8193,64803,Greater Shepparton (C),2016,6053355
22910,3,69,10,0,0,0,19,5,103,15,106,111,213,12,0,457,1,0,8,0,9,9,27,12,0,48,6,30,36,0,1,1,2,4,657,14728,Hepburn (S),2012,5632521
22910,0,57,10,0,1,1,18,5,92,23,106,110,177,27,0,443,1,5,7,0,13,10,25,7,0,42,7,14,21,0,0,1,1,2,613,14807,Hepburn (S),2013,5733545
22910,0,64,22,1,2,0,24,7,120,18,80,105,139,7,0,349,3,8,11,0,22,8,17,5,1,31,5,58,63,0,0,0,2,2,587,14885,Hepburn (S),2014,5838110
22910,0,60,42,0,1,0,12,8,123,21,61,145,253,23,0,503,2,3,27,0,32,18,10,4,0,32,4,52,56,0,0,0,0,0,746,14794,Hepburn (S),2015,5937481
22910,0,69,38,0,2,1,15,9,134,21,90,148,290,11,0,560,2,2,12,0,16,9,9,4,0,22,12,78,90,0,1,1,1,3,825,15175,Hepburn (S),2016,6053355
22980,0,25,10,0,0,0,4,3,42,3,40,25,51,5,0,124,3,3,27,0,33,21,17,1,0,39,4,10,14,0,0,0,0,0,252,5781,Hindmarsh (S),2012,5632521
22980,0,23,10,1,0,0,9,3,46,7,39,31,68,3,0,148,0,6,10,0,16,10,4,6,0,20,1,30,31,0,0,0,2,2,263,5693,Hindmarsh (S),2013,5733545
22980,0,31,9,0,0,0,13,0,53,4,19,21,35,3,0,82,0,1,19,0,20,15,5,1,0,21,1,34,35,0,0,0,2,2,213,5642,Hindmarsh (S),2014,5838110
22980,0,26,12,1,0,0,6,0,45,2,26,18,35,2,0,83,1,2,19,0,22,8,11,2,0,21,0,26,26,0,0,0,0,0,197,5494,Hindmarsh (S),2015,5937481
22980,0,53,18,0,0,0,19,9,99,2,30,34,83,2,0,151,0,2,14,0,16,7,5,3,0,15,9,59,68,0,0,0,0,0,349,5497,Hindmarsh (S),2016,6053355
23110,4,462,94,11,63,1,115,47,797,41,926,770,2988,357,0,5082,36,23,187,0,246,155,241,24,0,420,62,119,181,1,22,29,5,57,6783,88275,Hobsons Bay (C),2012,5632521
23110,3,542,94,13,44,2,136,62,893,42,853,760,2676,401,2,4734,63,18,257,0,338,186,258,22,0,466,83,222,305,1,14,10,3,28,6764,89384,Hobsons Bay (C),2013,5733545
23110,0,561,125,7,49,1,164,82,989,43,888,633,2740,401,0,4705,34,43,274,0,351,195,247,31,1,474,86,458,544,0,10,4,10,24,7087,91118,Hobsons Bay (C),2014,5838110
23110,3,529,144,9,48,2,153,64,949,31,765,592,2595,411,0,4394,40,19,219,0,278,236,157,52,2,447,107,539,646,1,7,16,6,30,6744,92761,Hobsons Bay (C),2015,5937481
23110,3,539,97,11,35,0,151,77,910,32,712,577,2603,343,0,4267,25,5,227,0,257,187,159,65,0,411,138,782,920,0,34,1,3,38,6803,93377,Hobsons Bay (C),2016,6053355
23190,3,300,85,4,0,1,65,23,478,19,225,110,462,106,0,922,12,3,95,0,110,61,183,31,0,275,51,124,175,0,2,3,6,11,1971,19631,Horsham (RC),2012,5632521
23190,0,283,45,3,1,0,65,18,415,12,248,161,1221,84,0,1726,9,2,63,0,74,44,127,45,0,216,45,134,179,0,0,1,0,1,2611,19666,Horsham (RC),2013,5733545
23190,3,269,52,5,6,1,127,26,486,19,263,138,476,38,0,934,18,5,145,0,168,61,146,31,0,238,38,367,405,0,0,48,3,51,2282,19691,Horsham (RC),2014,5838110
23190,3,335,113,7,2,0,72,13,542,26,432,150,585,85,0,1278,25,6,199,0,230,73,136,19,0,228,60,591,651,0,0,11,2,13,2942,19774,Horsham (RC),2015,5937481
23190,3,328,70,4,2,0,89,30,523,28,406,160,448,199,0,1241,10,8,140,0,158,60,130,25,0,215,75,656,731,1,0,5,2,8,2876,19886,Horsham (RC),2016,6053355
23270,3,1510,221,47,150,11,501,157,2597,156,1696,1703,5173,1167,0,9895,129,73,524,0,726,467,288,74,29,858,190,979,1169,0,20,7,13,40,15285,178034,Hume (C),2012,5632521
23270,3,1456,324,48,95,9,541,173,2646,201,1571,1574,4932,1127,0,9405,115,76,524,0,715,568,240,62,1,871,222,1119,1341,2,19,29,11,61,15039,183077,Hume (C),2013,5733545
23270,17,1495,408,22,78,14,503,202,2739,274,1584,1988,5855,1306,0,11007,124,63,512,0,699,577,332,100,5,1014,215,1898,2113,0,31,15,8,54,17626,188669,Hume (C),2014,5838110
23270,6,1513,371,45,107,24,626,243,2935,217,1571,2028,6211,1292,1,11320,161,55,947,0,1163,862,295,83,5,1245,338,2497,2835,0,11,18,12,41,19539,194006,Hume (C),2015,5937481
23270,18,1657,371,42,96,14,631,317,3146,592,1763,2308,7955,1344,0,13962,205,79,1011,0,1295,766,310,114,5,1195,741,2769,3510,0,37,22,106,165,23273,199220,Hume (C),2016,6053355
23350,0,43,16,7,1,0,3,4,74,4,51,53,170,11,0,289,1,0,17,0,18,24,55,6,0,85,7,24,31,0,0,5,2,7,504,15373,Indigo (S),2012,5632521
23350,0,33,10,0,0,0,10,4,57,7,49,56,167,11,0,290,4,2,26,0,32,18,19,11,0,48,9,39,48,0,1,4,5,10,485,15359,Indigo (S),2013,5733545
23350,0,39,42,0,3,0,18,7,109,9,39,52,88,9,0,197,9,3,17,0,29,27,22,4,0,53,3,29,32,1,0,1,1,3,423,15341,Indigo (S),2014,5838110
23350,0,40,40,1,2,0,18,4,105,9,36,63,121,4,0,233,2,1,19,0,22,23,17,6,0,46,6,15,21,0,0,0,0,0,427,15431,Indigo (S),2015,5937481
23350,0,47,6,1,2,0,14,8,78,15,48,41,83,12,0,199,5,1,20,0,26,28,16,3,0,47,13,48,61,0,0,0,2,2,413,15549,Indigo (S),2016,6053355
23430,3,714,204,10,88,4,205,64,1289,56,968,1043,3384,370,0,5821,42,37,303,0,382,193,359,57,0,609,209,503,712,1,18,92,2,113,8926,150014,Kingston (C),2012,5632521
23430,3,741,288,18,60,8,187,55,1357,41,1054,906,3209,882,0,6092,54,34,432,0,520,216,393,39,2,650,170,616,786,0,20,10,9,39,9444,151533,Kingston (C),2013,5733545
23430,0,730,286,9,46,3,214,77,1365,75,908,901,3507,618,0,6009,91,30,517,1,639,274,375,31,1,681,182,770,952,2,22,13,8,45,9691,153034,Kingston (C),2014,5838110
23430,3,623,354,11,69,6,227,74,1364,31,889,885,3630,1081,0,6516,119,20,620,0,759,298,342,54,0,694,160,1014,1174,0,23,17,5,45,10552,154477,Kingston (C),2015,5937481
23430,3,725,278,11,74,0,229,71,1388,43,866,1042,4184,836,0,6971,97,33,579,0,709,324,332,48,0,704,233,1338,1571,0,27,17,2,46,11389,155995,Kingston (C),2016,6053355
23670,3,604,250,13,64,5,220,65,1221,79,1464,810,3296,600,0,6249,80,11,278,2,371,189,236,63,0,488,146,389,535,0,19,17,3,39,8903,154583,Knox (C),2012,5632521
23670,3,724,219,11,58,4,157,74,1247,57,1003,894,3595,526,0,6075,99,27,367,0,493,200,225,33,1,459,89,380,469,0,12,9,39,60,8803,154760,Knox (C),2013,5733545
23670,3,802,331,14,63,3,165,87,1465,48,903,873,3852,711,0,6387,124,38,536,0,698,324,290,33,1,648,161,578,739,0,13,8,14,35,9972,155279,Knox (C),2014,5838110
23670,3,758,303,14,49,8,188,101,1421,34,968,888,3586,823,0,6299,178,32,509,0,719,300,265,36,1,602,198,916,1114,0,5,7,4,16,10171,155681,Knox (C),2015,5937481
23670,3,790,404,15,49,2,246,127,1633,58,853,940,4348,729,0,6928,118,40,663,0,821,355,221,69,1,646,258,1083,1341,0,11,20,2,33,11402,158017,Knox (C),2016,6053355
23810,3,1208,215,14,45,4,458,121,2065,101,1454,882,2247,329,0,5013,69,50,281,0,400,244,443,72,0,759,176,990,1166,0,7,8,8,23,9426,74001,Latrobe (C),2012,5632521
23810,5,1206,297,25,59,3,571,148,2314,125,1363,840,2363,363,1,5055,97,29,366,0,492,266,578,93,1,938,207,1265,1472,0,4,9,3,16,10287,73783,Latrobe (C),2013,5733545
23810,3,1346,321,32,49,5,607,175,2535,131,1355,695,2048,514,0,4743,115,39,518,0,672,376,546,93,0,1015,262,1934,2196,0,9,16,10,35,11196,73619,Latrobe (C),2014,5838110
23810,3,1406,306,28,62,3,533,208,2546,140,1683,862,2556,886,1,6128,164,49,666,0,879,394,567,138,0,1099,267,2336,2603,0,4,13,21,38,13293,73548,Latrobe (C),2015,5937481
23810,4,1587,397,26,55,6,572,185,2832,150,1564,1062,3208,501,0,6485,76,26,488,1,591,421,518,171,6,1116,349,2772,3121,0,0,11,12,23,14168,73903,Latrobe (C),2016,6053355
23940,0,47,31,2,1,0,23,2,106,8,58,66,109,6,0,247,0,1,12,0,13,5,22,0,0,27,8,14,22,0,5,5,3,13,428,7506,Loddon (S),2012,5632521
23940,0,40,28,3,0,0,9,3,83,5,38,40,125,5,0,213,2,2,15,0,19,7,14,1,0,22,1,18,19,0,2,0,1,3,359,7417,Loddon (S),2013,5733545
23940,4,37,8,0,0,0,13,11,73,11,32,23,83,17,0,166,2,5,11,0,18,7,11,5,0,23,2,237,239,0,1,0,0,1,520,7353,Loddon (S),2014,5838110
23940,3,44,20,1,0,0,16,9,90,16,31,47,89,5,0,188,2,5,17,0,24,21,13,2,0,36,7,15,22,0,1,1,3,5,365,7283,Loddon (S),2015,5937481
23940,0,68,34,2,0,0,19,3,126,3,49,62,116,12,0,242,4,1,44,0,49,7,15,5,0,27,15,59,74,0,0,0,1,1,519,7399,Loddon (S),2016,6053355
24130,3,143,44,0,0,0,39,13,239,20,271,204,464,42,0,1001,14,15,55,0,84,40,44,35,0,119,31,104,135,0,7,6,6,19,1597,43517,Macedon Ranges (S),2012,5632521
24130,0,211,63,0,6,0,86,19,385,45,211,170,473,58,0,957,22,3,66,0,91,48,64,20,0,132,31,178,209,0,8,6,5,19,1793,44056,Macedon Ranges (S),2013,5733545
24130,4,198,55,2,2,1,65,25,352,57,218,225,627,124,0,1251,27,10,78,0,115,67,46,25,2,140,34,234,268,0,1,11,5,17,2143,44702,Macedon Ranges (S),2014,5838110
24130,3,191,48,6,0,0,85,32,362,27,195,227,535,164,0,1148,39,6,178,0,223,94,45,13,0,152,43,253,296,0,4,6,1,11,2192,45308,Macedon Ranges (S),2015,5937481
24130,0,259,63,1,2,3,68,36,432,43,241,222,566,81,0,1153,40,6,156,0,202,132,41,38,1,212,78,510,588,0,5,10,5,20,2607,46272,Macedon Ranges (S),2016,6053355
24210,0,246,123,5,29,5,79,26,513,21,459,441,1568,252,1,2742,25,13,127,0,165,75,58,34,0,167,28,111,139,2,0,4,24,30,3756,117036,Manningham (C),2012,5632521
24210,0,267,67,6,22,4,224,24,614,26,431,428,1434,250,0,2569,36,14,146,0,196,79,70,20,2,171,31,271,302,0,1,8,15,24,3876,117409,Manningham (C),2013,5733545
24210,0,310,74,1,13,5,160,19,582,19,393,543,1571,339,0,2865,53,10,201,0,264,73,58,17,0,148,25,276,301,0,1,1,0,2,4162,118485,Manningham (C),2014,5838110
24210,3,276,135,4,19,4,146,25,609,27,355,614,1510,397,2,2905,32,30,144,1,207,78,72,18,0,168,41,321,362,0,1,1,6,8,4259,119442,Manningham (C),2015,5937481
24210,3,384,113,15,17,1,160,54,744,24,356,810,1762,394,0,3346,27,17,151,0,195,75,65,25,0,165,54,281,335,0,1,5,2,8,4793,121184,Manningham (C),2016,6053355
24250,0,25,13,0,0,0,13,15,66,5,41,46,139,7,0,238,1,3,14,0,18,12,36,4,1,53,7,32,39,0,9,4,1,14,428,8052,Mansfield (S),2012,5632521
24250,3,22,10,0,1,0,10,3,46,3,45,49,136,7,0,240,0,3,9,0,12,18,35,1,0,54,2,7,9,0,4,1,12,17,378,8177,Mansfield (S),2013,5733545
24250,0,44,13,1,1,0,19,13,91,11,83,34,182,24,0,334,5,4,20,0,29,24,35,7,0,66,9,30,39,1,7,7,16,31,590,8217,Mansfield (S),2014,5838110
24250,3,35,18,1,2,0,15,2,73,12,62,38,136,8,0,256,2,0,18,0,20,32,23,5,0,60,5,34,39,0,4,1,5,10,458,8300,Mansfield (S),2015,5937481
24250,0,44,24,2,1,0,19,7,97,8,77,56,197,8,0,346,14,3,29,0,46,42,36,9,2,89,8,55,63,0,14,1,7,22,663,8392,Mansfield (S),2016,6053355
24330,3,492,166,16,149,6,80,36,945,48,786,927,3994,428,0,6183,427,14,510,3,954,202,375,34,3,614,73,123,196,0,15,9,5,29,8921,76866,Maribyrnong (C),2012,5632521
24330,5,583,127,18,135,4,93,29,994,42,663,932,3508,584,2,5731,154,24,398,0,576,222,444,34,0,700,87,170,257,0,10,23,2,35,8293,79222,Maribyrnong (C),2013,5733545
24330,4,575,126,16,81,23,116,44,985,46,602,768,3567,690,0,5673,101,25,370,0,496,262,352,40,0,654,89,494,583,0,8,1,4,13,8404,81831,Maribyrnong (C),2014,5838110
24330,3,466,128,14,81,17,122,41,869,32,597,875,3545,612,0,5661,161,24,400,0,585,233,299,50,2,584,94,359,453,1,19,11,5,36,8188,83515,Maribyrnong (C),2015,5937481
24330,4,536,107,17,99,8,138,38,947,46,682,793,4123,811,0,6455,137,20,435,0,592,269,244,87,1,601,126,409,535,1,25,9,3,38,9168,86877,Maribyrnong (C),2016,6053355
24410,3,453,157,5,35,149,75,39,913,41,742,658,2182,330,0,3953,46,11,187,0,244,101,248,18,1,368,85,733,818,0,16,7,8,31,6327,108168,Maroondah (C),2012,5632521
24410,3,577,128,5,39,2,126,42,919,50,675,681,1981,355,0,3742,83,11,269,0,363,192,291,23,0,506,88,688,776,0,32,10,7,49,6355,109466,Maroondah (C),2013,5733545
24410,3,602,145,15,37,0,179,40,1018,33,774,625,2438,425,0,4295,60,26,237,0,323,137,325,39,2,503,116,1136,1252,0,11,36,3,50,7441,111185,Maroondah (C),2014,5838110
24410,3,585,169,8,41,5,180,92,1080,32,708,547,2546,536,3,4372,72,25,338,0,435,217,299,30,1,547,110,1249,1359,1,4,10,2,17,7810,112310,Maroondah (C),2015,5937481
24410,0,669,217,16,30,6,174,60,1172,59,657,596,2762,474,0,4548,126,19,480,0,625,306,281,58,0,645,219,1376,1595,0,14,11,4,29,8614,112971,Maroondah (C),2016,6053355
24600,10,2360,322,37,320,13,381,124,3567,53,1685,1604,11319,3905,3,18569,228,23,1348,3,1602,552,4968,350,20,5890,498,1778,2276,0,42,81,25,148,32052,105418,Melbourne (C),2012,5632521
24600,5,2283,437,23,223,26,605,139,3741,55,1643,1528,12549,5067,0,20842,251,56,1687,0,1994,584,4857,309,6,5756,527,2045,2572,1,42,139,17,199,35104,116330,Melbourne (C),2013,5733545
24600,9,2294,421,30,222,14,488,152,3630,41,1602,1404,10271,4087,0,17405,370,90,1643,2,2105,713,4037,270,26,5046,573,2861,3434,1,52,90,16,159,31779,122167,Melbourne (C),2014,5838110
24600,9,2250,475,59,285,25,454,134,3691,48,1699,1718,10988,5048,2,19503,330,43,1744,1,2118,739,3404,278,129,4550,646,3038,3684,2,51,72,27,152,33698,128980,Melbourne (C),2015,5937481
24600,8,2748,526,46,419,19,506,187,4459,56,1899,2107,12703,4714,1,21480,305,33,1599,1,1938,825,2944,295,10,4074,871,3115,3986,1,73,52,24,150,36087,137340,Melbourne (C),2016,6053355
24650,3,868,150,20,48,0,187,95,1368,117,1215,1195,2978,281,0,5786,71,47,252,0,370,237,173,39,0,449,109,231,340,2,4,88,8,102,8415,117881,Melton (S),2012,5632521
24650,4,1035,177,16,66,2,274,105,1679,130,935,1148,2812,704,0,5729,77,79,226,0,382,252,152,28,0,432,128,519,647,0,5,4,7,16,8885,122786,Melton (S),2013,5733545
24650,7,853,137,21,63,8,246,106,1441,142,963,1173,3561,483,1,6323,113,53,346,1,513,330,199,26,2,557,132,788,920,0,0,3,5,8,9762,127638,Melton (S),2014,5838110
24650,6,839,197,18,40,2,302,114,1518,107,937,1163,3920,696,8,6831,94,80,416,4,594,371,224,32,0,627,154,986,1140,0,4,1,8,13,10723,132752,Melton (S),2015,5937481
24650,3,1058,200,17,55,1,303,201,1835,120,964,1358,4514,591,18,7565,109,67,461,1,638,484,253,59,3,799,286,1299,1585,0,10,3,11,24,12446,136539,Melton (S),2016,6053355
24780,0,566,73,16,41,2,121,39,858,65,680,640,1439,124,0,2948,36,25,199,0,260,120,587,43,0,750,69,353,422,1,0,9,4,14,5252,52197,Mildura (RC),2012,5632521
24780,3,598,144,7,15,5,150,50,969,67,690,680,1366,208,0,3011,55,27,249,1,332,197,503,34,0,734,74,387,461,0,2,5,2,9,5516,52633,Mildura (RC),2013,5733545
24780,3,558,85,7,22,8,143,57,880,62,595,768,1435,207,0,3067,74,16,344,0,434,263,425,55,0,743,80,577,657,0,0,6,7,13,5794,53018,Mildura (RC),2014,5838110
24780,3,595,127,7,11,3,121,66,930,57,648,594,1472,281,0,3052,52,24,318,0,394,242,410,38,0,690,78,810,888,0,1,21,4,26,5980,53015,Mildura (RC),2015,5937481
24780,6,750,133,19,18,1,161,109,1197,75,667,720,1595,237,0,3294,81,22,283,0,386,188,345,83,0,616,165,853,1018,0,0,6,5,11,6522,53687,Mildura (RC),2016,6053355
24850,4,320,68,1,5,0,98,63,559,32,374,228,566,49,0,1249,7,13,88,0,108,79,187,57,2,325,97,155,252,0,3,12,26,41,2534,36143,Mitchell (S),2012,5632521
24850,3,358,114,3,2,0,134,44,655,40,327,279,652,206,0,1504,22,13,103,0,138,104,134,36,1,275,50,168,218,1,3,2,7,13,2803,37325,Mitchell (S),2013,5733545
24850,3,399,104,5,5,2,173,63,751,36,345,208,644,326,0,1559,15,13,111,0,139,139,116,35,0,290,55,386,441,1,3,1,6,11,3191,38393,Mitchell (S),2014,5838110
24850,4,413,134,12,7,2,187,76,835,49,367,280,857,241,0,1794,22,13,157,0,192,140,111,64,0,315,76,790,866,1,8,4,4,17,4019,39143,Mitchell (S),2015,5937481
24850,3,530,92,4,4,4,212,102,948,70,417,354,1006,233,0,2080,26,29,195,0,250,160,108,49,0,317,160,643,803,1,14,6,4,25,4423,40732,Mitchell (S),2016,6053355
24900,3,110,37,3,2,0,30,15,197,17,164,214,416,26,0,837,4,6,86,0,96,55,110,2,0,167,36,85,121,0,1,1,2,4,1422,28647,Moira (S),2012,5632521
24900,3,114,63,1,3,0,28,13,222,16,137,195,404,18,0,770,26,20,71,0,117,43,73,8,0,124,20,70,90,1,0,9,2,12,1335,28645,Moira (S),2013,5733545
24900,3,157,95,1,4,1,39,14,311,27,177,161,332,30,0,727,25,5,121,0,151,36,67,7,0,110,21,143,164,0,0,4,1,5,1468,28825,Moira (S),2014,5838110
24900,0,166,97,0,2,0,35,27,327,39,157,139,303,33,0,671,20,12,123,0,155,58,100,12,0,170,11,173,184,0,1,0,5,6,1513,28820,Moira (S),2015,5937481
24900,3,156,136,3,0,0,36,34,365,19,152,164,385,77,0,797,36,10,129,0,175,98,62,15,0,175,50,150,200,0,1,3,0,4,1716,29155,Moira (S),2016,6053355
24970,9,504,182,9,88,7,164,69,1032,46,901,1310,3787,836,0,6880,47,16,150,1,214,107,157,24,0,288,45,188,233,2,1,5,3,11,8658,179931,Monash (C),2012,5632521
24970,3,483,277,5,85,3,152,74,1079,48,747,1307,3625,834,1,6562,43,29,210,0,282,124,235,27,247,633,56,221,277,0,3,8,19,30,8863,182300,Monash (C),2013,5733545
24970,3,596,195,17,99,4,232,82,1225,38,712,1327,3472,1302,0,6851,100,51,355,1,507,188,254,18,2,462,72,494,566,0,15,10,6,31,9642,184977,Monash (C),2014,5838110
24970,3,637,253,16,75,10,214,67,1272,45,764,1295,3808,911,0,6823,72,67,396,0,535,249,219,42,1,511,104,705,809,0,7,3,1,11,9961,187286,Monash (C),2015,5937481
24970,3,757,185,14,132,4,220,85,1397,60,828,1534,4433,2315,0,9170,61,39,386,7,493,215,186,52,1,454,195,791,986,0,9,8,2,19,12519,189236,Monash (C),2016,6053355
25060,3,574,81,9,95,4,201,32,996,17,889,1015,3150,606,1,5678,44,15,281,0,340,133,322,35,3,493,86,254,340,0,11,4,9,24,7871,113513,Moonee Valley (C),2012,5632521
25060,4,563,105,8,60,4,292,63,1099,48,831,964,3007,490,0,5340,56,23,288,0,367,143,255,48,0,446,63,252,315,1,5,17,12,35,7602,114979,Moonee Valley (C),2013,5733545
25060,3,608,143,7,71,3,207,44,1083,27,758,913,3169,899,0,5766,66,13,374,0,453,157,257,62,0,476,78,494,572,0,6,2,6,14,8364,117297,Moonee Valley (C),2014,5838110
25060,4,597,132,14,74,3,242,63,1129,32,695,923,3670,952,0,6272,99,22,428,239,788,225,231,32,0,488,131,650,781,0,9,5,42,56,9514,119583,Moonee Valley (C),2015,5937481
25060,3,670,173,8,57,8,223,92,1231,37,675,890,4334,625,0,6561,74,17,463,0,554,228,229,59,0,516,188,768,956,0,13,3,2,18,9836,121382,Moonee Valley (C),2016,6053355
25150,0,126,24,0,4,0,38,19,211,19,201,204,577,31,0,1032,13,12,27,0,52,40,50,5,0,95,8,63,71,0,5,2,4,11,1472,29347,Moorabool (S),2012,5632521
25150,5,158,33,1,4,1,46,13,261,43,224,231,619,56,0,1173,14,13,64,0,91,58,55,7,0,120,25,84,109,0,3,0,1,4,1758,30313,Moorabool (S),2013,5733545
25150,0,122,94,7,2,0,47,31,303,39,223,223,580,131,0,1196,23,12,60,0,95,60,45,13,0,118,13,129,142,0,5,3,6,14,1868,30911,Moorabool (S),2014,5838110
25150,3,171,79,1,2,0,43,25,321,25,192,223,704,72,1,1217,14,5,78,0,97,78,36,14,0,128,18,214,232,0,5,4,3,12,2007,31496,Moorabool (S),2015,5937481
25150,3,223,87,5,7,3,58,42,425,55,246,247,778,94,0,1420,27,10,81,0,118,82,31,11,3,127,78,304,382,0,3,4,3,10,2482,32420,Moorabool (S),2016,6053355
25250,7,829,206,39,135,6,217,77,1516,78,1251,1568,4957,636,0,8490,43,37,333,0,413,266,206,46,1,519,89,333,422,0,9,17,6,32,11392,156657,Moreland (C),2012,5632521
25250,3,832,242,20,109,4,229,95,1531,65,1046,1481,4526,1290,0,8408,78,32,461,0,571,291,299,44,1,635,110,569,679,0,10,7,5,22,11846,159867,Moreland (C),2013,5733545
25250,3,830,226,21,71,7,266,118,1539,93,1029,1755,5182,958,0,9017,57,32,392,1,482,298,250,56,0,604,120,756,876,0,13,38,5,56,12574,163331,Moreland (C),2014,5838110
25250,3,1037,255,23,62,11,291,100,1779,73,1127,1695,5615,964,0,9474,71,32,428,0,531,276,248,49,3,576,211,983,1194,0,11,7,4,22,13576,166770,Moreland (C),2015,5937481
25250,10,1011,222,30,84,7,299,140,1803,95,1124,1837,6466,959,0,10481,165,42,501,0,708,271,259,73,1,604,470,1029,1499,0,32,10,6,48,15143,170178,Moreland (C),2016,6053355
25340,5,783,175,4,41,0,236,92,1336,126,1173,1030,3024,372,0,5725,87,25,274,2,388,159,663,69,3,894,125,456,581,2,12,17,2,33,8957,150830,Mornington Peninsula (S),2012,5632521
25340,5,790,290,12,25,1,208,113,1444,101,1173,1075,2979,402,0,5730,77,37,210,0,324,202,562,48,1,813,165,631,796,4,11,26,12,53,9160,152106,Mornington Peninsula (S),2013,5733545
25340,5,869,221,16,32,2,231,114,1490,83,1141,1130,3141,644,0,6139,121,35,339,0,495,233,626,77,0,936,143,1068,1211,1,16,25,21,63,10334,153749,Mornington Peninsula (S),2014,5838110
25340,10,867,184,16,24,1,329,122,1553,67,1067,1088,2895,749,0,5866,140,48,482,0,670,323,725,52,0,1100,191,1355,1546,0,18,11,8,37,10772,155015,Mornington Peninsula (S),2015,5937481
25340,5,932,308,16,38,3,303,123,1728,93,1114,1524,3211,494,1,6437,111,59,530,0,700,409,692,94,2,1197,306,1577,1883,0,9,8,4,21,11966,157787,Mornington Peninsula (S),2016,6053355
25430,3,115,25,2,4,1,42,11,200,13,100,79,213,43,0,448,5,13,31,0,49,30,51,10,0,91,30,109,139,0,1,3,3,7,934,17896,Mount Alexander (S),2012,5632521
25430,0,125,30,0,3,0,57,11,226,32,104,59,254,24,0,473,13,6,32,0,51,34,34,20,0,88,19,121,140,0,0,5,4,9,987,17964,Mount Alexander (S),2013,5733545
25430,0,166,43,1,1,1,23,18,253,16,109,75,231,136,0,567,12,9,52,1,74,43,36,6,0,85,15,182,197,0,1,1,1,3,1179,18087,Mount Alexander (S),2014,5838110
25430,3,182,19,0,3,1,49,19,273,32,94,62,205,18,0,411,18,3,65,0,86,34,51,11,0,96,31,163,194,0,3,9,3,15,1075,18130,Mount Alexander (S),2015,5937481
25430,0,251,37,0,3,0,38,10,339,25,147,128,341,46,0,687,7,6,59,0,72,33,56,34,0,123,60,221,281,0,1,1,4,6,1508,18360,Mount Alexander (S),2016,6053355
25490,3,177,79,2,3,0,21,16,298,35,160,61,257,123,0,636,4,3,36,0,43,26,120,9,0,155,30,67,97,1,0,4,5,10,1239,16226,Moyne (S),2012,5632521
25490,0,133,41,2,2,0,50,13,241,20,107,43,214,26,0,410,12,4,34,0,50,33,74,26,0,133,28,95,123,0,0,1,1,2,959,16295,Moyne (S),2013,5733545
25490,3,183,72,2,6,0,46,23,332,12,150,47,218,48,0,475,28,3,130,4,165,38,69,11,1,119,23,236,259,1,3,3,1,8,1358,16336,Moyne (S),2014,5838110
25490,0,141,45,2,3,1,51,26,269,8,88,46,143,26,0,311,26,4,58,0,88,36,41,4,0,81,23,200,223,0,0,1,4,5,977,16229,Moyne (S),2015,5937481
25490,3,141,67,3,3,2,48,27,291,9,63,64,179,42,0,357,13,9,63,0,85,48,44,8,0,100,33,195,228,0,0,1,0,1,1062,16503,Moyne (S),2016,6053355
25620,3,60,23,0,0,0,19,15,117,9,72,51,154,12,0,298,4,11,24,0,39,42,52,3,0,97,12,14,26,0,9,3,3,15,592,13423,Murrindindi (S),2012,5632521
25620,4,74,29,0,0,1,14,14,136,11,61,72,155,5,0,304,2,8,29,0,39,76,44,6,0,126,4,15,19,0,7,0,9,16,640,13477,Murrindindi (S),2013,5733545
25620,3,80,22,0,0,0,24,5,131,9,64,62,151,23,0,309,19,15,29,0,63,37,51,5,0,93,14,50,64,0,6,8,4,18,678,13589,Murrindindi (S),2014,5838110
25620,3,52,13,1,0,0,39,13,118,6,55,115,171,10,0,357,1,4,8,0,13,11,40,3,0,54,13,34,47,3,4,7,6,20,609,13693,Murrindindi (S),2015,5937481
25620,0,83,52,1,0,1,22,15,174,23,60,104,171,18,0,376,1,14,14,0,29,22,44,12,0,78,13,36,49,0,4,2,2,8,714,13713,Murrindindi (S),2016,6053355
25710,3,179,90,9,13,0,61,34,386,22,332,244,497,65,0,1160,18,11,85,0,114,50,34,27,0,111,15,95,110,0,0,3,0,3,1884,62751,Nillumbik (S),2012,5632521
25710,0,192,56,1,6,0,61,16,332,34,471,239,589,98,0,1431,6,5,50,0,61,44,61,26,1,132,7,111,118,0,2,1,12,15,2089,62660,Nillumbik (S),2013,5733545
25710,3,152,76,1,6,0,49,18,302,26,271,278,704,216,0,1495,7,10,59,0,76,31,45,11,0,87,11,146,157,0,4,1,4,9,2126,62849,Nillumbik (S),2014,5838110
25710,3,179,76,1,4,3,58,22,343,35,313,275,835,711,0,2169,12,2,80,0,94,46,45,8,0,99,25,238,263,0,0,3,1,4,2972,62602,Nillumbik (S),2015,5937481
25710,3,199,88,4,11,0,66,25,393,29,333,308,1143,146,0,1959,3,6,88,0,97,40,32,18,0,90,40,317,357,0,14,4,4,22,2918,63090,Nillumbik (S),2016,6053355
25810,0,132,40,0,0,1,22,29,224,20,130,63,192,10,0,415,15,6,56,0,77,39,66,23,0,128,13,67,80,0,1,1,2,4,928,11945,Northern Grampians (S),2012,5632521
25810,3,150,66,0,1,0,41,15,273,13,148,57,163,1048,0,1429,7,4,43,0,54,41,70,8,0,119,23,65,88,0,0,1,6,7,1970,11775,Northern Grampians (S),2013,5733545
25810,3,151,38,1,0,0,42,16,248,13,117,43,138,22,0,333,10,3,74,0,87,36,59,12,0,107,28,102,130,0,1,10,0,11,916,11715,Northern Grampians (S),2014,5838110
25810,0,119,26,2,2,1,102,23,275,85,144,51,167,31,0,478,22,6,67,0,95,50,64,21,0,135,9,87,96,0,1,1,8,10,1089,11509,Northern Grampians (S),2015,5937481
25810,0,138,49,2,2,1,39,30,261,28,166,96,174,14,0,478,9,6,99,0,114,60,86,14,0,160,64,204,268,0,1,4,2,7,1288,11657,Northern Grampians (S),2016,6053355
25900,6,812,184,15,107,0,273,79,1476,31,1068,968,3661,751,0,6479,91,11,415,0,517,198,994,74,3,1269,134,269,403,1,13,153,2,169,10313,100394,Port Phillip (C),2012,5632521
25900,3,829,173,12,95,7,175,47,1338,43,1024,1106,4365,1168,2,7708,95,19,417,4,535,252,1117,65,8,1442,157,319,476,0,1,85,7,93,11592,102396,Port Phillip (C),2013,5733545
25900,3,783,154,22,79,7,239,56,1340,34,920,1071,4213,1236,0,7474,118,15,584,0,717,250,1012,63,0,1325,144,837,981,4,4,20,2,30,11867,104813,Port Phillip (C),2014,5838110
25900,3,844,264,16,67,5,383,62,1641,30,902,1155,4665,1075,0,7827,115,25,723,4,867,353,735,72,3,1163,204,722,926,1,19,25,3,48,12472,107127,Port Phillip (C),2015,5937481
25900,4,899,187,15,78,6,253,87,1529,68,940,1251,5505,1122,0,8886,125,12,667,1,805,283,599,62,1,945,183,777,960,1,19,28,6,54,13179,108049,Port Phillip (C),2016,6053355
25990,0,33,4,0,0,0,9,4,50,4,27,40,78,5,0,154,4,3,7,0,14,9,4,3,0,16,0,5,5,0,0,0,0,0,239,6746,Pyrenees (S),2012,5632521
25990,0,36,21,0,0,0,6,4,67,13,22,56,87,8,0,186,2,1,11,0,14,24,5,2,0,31,5,13,18,0,3,0,2,5,321,6759,Pyrenees (S),2013,5733545
25990,3,43,35,0,0,0,10,8,96,10,53,65,131,5,0,264,1,1,10,0,12,10,10,6,0,26,2,21,23,0,0,1,4,5,426,6791,Pyrenees (S),2014,5838110
25990,0,44,33,0,0,0,13,7,97,23,30,57,107,10,0,227,7,0,19,0,26,19,3,12,0,34,5,27,32,0,0,5,4,9,425,6822,Pyrenees (S),2015,5937481
25990,3,61,15,0,1,0,14,20,111,19,47,64,130,4,0,264,10,2,10,0,22,8,14,9,0,31,9,90,99,0,1,1,0,2,529,6902,Pyrenees (S),2016,6053355
26080,0,8,3,0,1,0,3,0,12,0,13,12,57,0,0,82,0,0,0,0,0,0,9,0,0,9,4,2,6,0,3,0,0,3,112,3085,Queenscliffe (B),2012,5632521
26080,0,4,3,0,0,0,1,1,6,1,13,16,40,1,0,71,0,0,2,0,2,1,3,0,0,4,0,0,0,0,0,0,0,0,83,3054,Queenscliffe (B),2013,5733545
26080,0,1,0,0,0,0,1,0,2,1,14,9,36,0,0,60,0,0,0,0,0,0,6,15,0,21,3,0,3,0,0,0,0,0,86,3033,Queenscliffe (B),2014,5838110
26080,0,3,4,1,0,0,0,0,8,1,16,13,46,1,0,77,0,0,1,0,1,0,3,8,0,11,0,6,6,0,3,0,0,3,106,3017,Queenscliffe (B),2015,5937481
26080,0,5,3,0,0,0,0,1,6,0,20,17,60,2,0,99,0,0,1,0,1,0,3,1,0,4,1,2,3,0,1,0,0,1,114,3035,Queenscliffe (B),2016,6053355
26170,3,116,47,2,2,1,25,13,206,14,154,205,306,22,0,701,9,7,37,0,53,25,121,8,0,154,14,97,111,0,1,1,0,2,1227,27756,South Gippsland (S),2012,5632521
26170,3,104,28,3,2,2,47,18,204,15,152,219,502,23,0,911,27,6,50,0,83,40,73,11,0,124,13,115,128,0,2,0,0,2,1452,27895,South Gippsland (S),2013,5733545
26170,3,129,74,1,4,0,47,20,275,12,134,122,307,100,0,675,5,8,57,0,70,33,46,6,0,85,15,129,144,0,2,1,8,11,1260,27838,South Gippsland (S),2014,5838110
26170,4,136,107,5,0,0,58,20,330,13,154,158,299,53,0,677,14,11,45,0,70,45,36,12,0,93,103,201,304,0,2,0,2,4,1478,27706,South Gippsland (S),2015,5937481
26170,3,177,70,2,1,1,57,32,340,17,168,153,331,16,0,685,13,19,46,0,78,47,31,7,0,85,36,274,310,0,0,4,2,6,1504,28112,South Gippsland (S),2016,6053355
26260,3,107,42,0,0,0,21,10,180,16,162,72,251,5,0,506,2,3,40,0,45,24,136,20,0,180,17,42,59,0,0,10,2,12,982,16372,Southern Grampians (S),2012,5632521
26260,3,96,66,3,2,0,20,14,201,10,193,106,228,50,0,587,8,7,61,0,76,17,105,20,0,142,17,49,66,0,0,4,4,8,1080,16133,Southern Grampians (S),2013,5733545
26260,0,85,68,0,1,0,31,31,216,14,169,43,191,32,0,449,8,3,75,0,86,32,94,14,0,140,12,129,141,0,0,4,9,13,1045,15906,Southern Grampians (S),2014,5838110
26260,0,116,56,0,0,0,34,14,220,8,131,81,244,59,0,523,8,3,38,0,49,37,67,14,0,118,14,119,133,0,2,1,6,9,1052,15751,Southern Grampians (S),2015,5937481
26260,3,132,68,2,1,0,48,28,279,10,115,86,266,39,0,516,23,3,93,0,119,46,66,22,0,134,74,191,265,0,1,4,1,6,1319,15869,Southern Grampians (S),2016,6053355
26350,3,621,114,7,66,2,123,82,1015,25,900,960,3543,739,0,6167,52,10,356,0,418,98,733,28,0,859,54,143,197,1,8,13,13,35,8691,101187,Stonnington (C),2012,5632521
26350,6,555,185,11,53,7,139,45,1001,19,782,1123,3574,1076,0,6574,50,83,392,1,526,171,642,34,1,848,61,319,380,0,2,21,7,30,9359,103085,Stonnington (C),2013,5733545
26350,5,462,120,6,40,1,98,68,800,27,677,1096,3854,928,0,6582,88,20,357,2,467,132,682,66,3,883,89,370,459,1,18,40,3,62,9253,105946,Stonnington (C),2014,5838110
26350,4,553,138,7,44,4,131,66,947,10,721,1248,4063,938,0,6980,98,40,428,1,567,200,563,30,3,796,147,514,661,0,8,8,4,20,9971,107941,Stonnington (C),2015,5937481
26350,4,602,212,17,70,5,124,65,1099,13,673,1303,5141,1118,0,8248,153,25,543,1,722,240,463,36,2,741,162,495,657,0,11,4,0,15,11482,112119,Stonnington (C),2016,6053355
26430,0,38,9,2,0,0,16,15,80,5,53,43,145,5,0,251,1,6,13,0,20,11,26,3,0,40,4,10,14,0,0,0,19,19,424,9666,Strathbogie (S),2012,5632521
26430,0,29,19,1,0,0,18,6,73,8,55,47,139,27,0,276,8,2,28,0,38,14,32,2,1,49,7,12,19,0,2,0,1,3,458,9702,Strathbogie (S),2013,5733545
26430,0,54,32,0,2,0,26,10,124,3,28,52,146,17,2,248,5,5,26,0,36,16,19,0,0,35,8,25,33,0,1,0,0,1,477,9814,Strathbogie (S),2014,5838110
26430,0,40,29,0,0,0,23,8,100,5,30,50,108,30,0,223,2,2,15,0,19,12,11,2,0,25,10,107,117,0,1,0,1,2,486,9826,Strathbogie (S),2015,5937481
26430,3,56,26,1,0,0,22,17,122,11,42,66,194,15,0,328,13,4,14,0,31,12,10,1,0,23,9,67,76,1,13,0,0,14,594,9938,Strathbogie (S),2016,6053355
26490,3,83,16,1,1,0,18,12,131,11,172,199,544,25,0,951,0,4,17,0,21,27,116,10,0,153,19,28,47,0,1,17,0,18,1321,27474,Surf Coast (S),2012,5632521
26490,3,81,36,1,0,0,13,7,138,13,144,184,389,28,0,758,5,3,38,0,46,26,116,12,0,154,18,32,50,0,0,9,0,9,1155,28262,Surf Coast (S),2013,5733545
26490,0,58,16,3,1,0,66,16,160,7,110,170,445,41,0,773,2,8,35,0,45,21,83,8,0,112,8,89,97,0,1,1,0,2,1189,28460,Surf Coast (S),2014,5838110
26490,0,74,65,0,2,1,16,5,163,9,140,174,434,410,0,1167,7,7,47,0,61,18,55,9,0,82,8,91,99,0,6,2,0,8,1580,28941,Surf Coast (S),2015,5937481
26490,0,97,38,6,11,0,27,22,201,22,132,216,578,54,0,1002,3,2,31,0,36,10,51,2,0,63,22,94,116,0,1,0,0,1,1419,29337,Surf Coast (S),2016,6053355
26610,3,263,63,3,7,0,65,22,423,23,213,135,423,55,0,849,20,5,85,0,110,48,177,11,1,237,46,135,181,0,0,5,4,9,1809,20950,Swan Hill (RC),2012,5632521
26610,3,278,40,3,5,0,64,25,415,27,219,122,311,43,0,722,23,2,74,0,99,58,156,11,0,225,69,173,242,0,0,3,2,5,1708,20849,Swan Hill (RC),2013,5733545
26610,3,261,71,4,4,1,77,25,443,16,226,133,424,40,0,839,32,21,74,0,127,110,189,20,2,321,45,337,382,0,1,0,2,3,2115,20574,Swan Hill (RC),2014,5838110
26610,0,275,62,1,1,1,47,59,446,20,206,151,376,91,0,844,30,10,157,0,197,125,187,24,1,337,69,366,435,2,0,4,6,12,2271,20409,Swan Hill (RC),2015,5937481
26610,0,284,39,3,5,2,59,52,444,21,205,155,422,55,0,858,23,8,107,0,138,117,114,29,1,261,102,339,441,0,0,9,8,17,2159,20679,Swan Hill (RC),2016,6053355
26670,0,26,9,0,0,0,25,2,62,8,38,20,69,3,0,138,0,3,11,0,14,34,15,1,0,50,9,5,14,0,0,2,14,16,294,5910,Towong (S),2012,5632521
26670,0,29,4,1,0,0,19,5,58,4,44,18,68,2,0,136,1,0,1,0,2,15,30,3,0,48,11,14,25,0,0,0,0,0,269,5884,Towong (S),2013,5733545
26670,0,32,29,0,1,0,8,2,72,4,31,22,68,2,0,127,0,2,3,0,5,2,17,3,0,22,9,7,16,0,0,1,1,2,244,5795,Towong (S),2014,5838110
26670,0,26,3,0,0,0,7,2,35,1,28,17,50,0,0,96,0,1,3,0,4,18,5,1,0,24,0,5,5,0,0,0,1,1,165,5762,Towong (S),2015,5937481
26670,0,26,23,0,0,0,10,8,67,6,24,18,59,11,0,118,2,2,11,0,15,33,10,2,0,45,1,27,28,0,0,2,3,5,278,5740,Towong (S),2016,6053355
26700,3,220,102,2,1,0,59,23,407,27,236,103,557,49,0,972,45,16,159,0,220,107,303,27,0,437,60,144,204,0,4,27,22,53,2293,27221,Wangaratta (RC),2012,5632521
26700,3,226,104,7,4,1,81,23,446,35,265,144,539,34,0,1017,48,11,147,0,206,106,330,46,1,483,70,179,249,1,0,10,20,31,2432,27169,Wangaratta (RC),2013,5733545
26700,0,234,72,6,4,0,68,47,431,37,255,149,458,89,0,988,77,11,138,0,226,87,302,22,0,411,105,268,373,1,0,6,1,8,2437,27108,Wangaratta (RC),2014,5838110
26700,0,218,59,5,1,1,81,31,396,27,272,96,441,120,0,956,128,8,135,1,272,106,318,32,1,457,81,329,410,1,0,3,14,18,2509,27065,Wangaratta (RC),2015,5937481
26700,6,276,92,2,0,0,62,43,481,30,302,129,515,84,0,1060,35,20,133,0,188,135,213,37,1,386,58,361,419,0,0,12,44,56,2590,27410,Wangaratta (RC),2016,6053355
26730,3,183,48,2,3,0,57,26,319,38,356,170,449,76,0,1089,20,5,69,0,94,43,142,22,0,207,47,123,170,1,0,9,0,10,1889,33004,Warrnambool (C),2012,5632521
26730,0,257,65,4,7,0,73,26,432,12,343,194,457,74,0,1080,23,3,58,0,84,43,118,18,0,179,56,138,194,0,0,4,5,9,1978,33240,Warrnambool (C),2013,5733545
26730,0,214,88,1,4,1,98,10,416,18,341,177,429,111,0,1076,38,2,66,0,106,51,107,8,0,166,45,235,280,0,0,1,3,4,2048,33508,Warrnambool (C),2014,5838110
26730,0,249,66,12,7,0,85,30,449,10,301,241,510,83,0,1145,108,9,154,0,271,60,109,24,0,193,81,419,500,1,1,4,0,6,2564,33644,Warrnambool (C),2015,5937481
26730,0,237,64,3,4,0,85,43,436,10,310,294,596,89,0,1299,67,11,22,1,101,122,89,37,1,249,65,363,428,0,1,4,2,7,2520,33795,Warrnambool (C),2016,6053355
26810,0,477,98,2,11,1,142,59,790,36,470,457,807,100,0,1870,40,14,107,0,161,98,172,38,0,308,66,288,354,0,9,8,4,21,3504,42294,Wellington (S),2012,5632521
26810,0,516,104,1,13,1,160,34,829,85,486,497,1213,99,0,2380,33,22,118,0,173,93,109,29,0,231,92,331,423,1,4,2,8,15,4051,42272,Wellington (S),2013,5733545
26810,6,542,163,5,3,4,159,42,924,54,511,458,973,291,0,2287,16,22,149,0,187,153,161,38,0,352,108,421,529,0,1,4,7,12,4291,42174,Wellington (S),2014,5838110
26810,3,626,175,4,1,0,197,44,1047,46,472,450,793,144,0,1905,54,15,169,0,238,167,196,74,0,437,141,581,722,0,3,15,7,25,4374,41965,Wellington (S),2015,5937481
26810,3,613,291,8,4,1,193,46,1156,65,455,518,886,101,1,2026,23,26,233,0,282,160,179,49,0,388,195,697,892,0,0,10,3,13,4757,42467,Wellington (S),2016,6053355
26890,3,21,16,0,0,0,4,1,42,2,15,17,26,1,0,61,0,3,13,0,16,3,17,0,0,20,0,5,5,1,0,0,3,4,148,4195,West Wimmera (S),2012,5632521
26890,0,10,6,0,0,0,2,1,19,1,22,24,51,5,0,103,0,0,8,0,8,1,6,2,0,9,2,6,8,0,0,0,2,2,149,4084,West Wimmera (S),2013,5733545
26890,0,19,7,0,0,0,6,5,37,3,9,10,36,3,0,61,1,2,8,0,11,4,4,2,0,10,4,36,40,0,0,0,0,0,159,3981,West Wimmera (S),2014,5838110
26890,0,23,33,0,0,0,7,1,64,2,11,5,22,2,0,42,0,3,8,0,11,13,5,0,0,18,2,17,19,0,0,0,0,0,154,3879,West Wimmera (S),2015,5937481
26890,0,15,14,0,0,0,19,4,52,2,9,15,27,11,0,64,0,3,13,0,16,8,6,2,0,16,3,16,19,0,0,0,0,0,167,3933,West Wimmera (S),2016,6053355
26980,4,438,178,10,68,0,114,29,841,33,743,853,2753,321,2,4705,56,26,174,0,256,101,171,26,4,302,74,124,198,0,8,26,26,60,6362,159296,Whitehorse (C),2012,5632521
26980,3,443,185,10,70,1,105,49,863,41,729,1053,3102,446,0,5371,35,11,199,0,245,123,229,46,2,400,104,160,264,0,13,12,39,64,7207,161560,Whitehorse (C),2013,5733545
26980,0,475,214,11,59,3,171,44,977,25,685,1049,3099,610,0,5468,63,29,218,1,311,167,143,28,0,338,57,601,658,0,13,17,1,31,7783,163646,Whitehorse (C),2014,5838110
26980,0,549,298,6,69,3,133,62,1120,38,617,960,2764,1502,0,5881,61,25,290,2,378,112,155,44,1,312,67,609,676,0,5,4,4,13,8380,165557,Whitehorse (C),2015,5937481
26980,4,588,230,13,53,3,180,47,1118,21,533,907,3002,698,0,5161,35,17,210,0,262,113,171,30,0,314,143,713,856,0,7,6,3,16,7727,168949,Whitehorse (C),2016,6053355
27070,6,967,186,27,73,6,342,133,1740,83,1391,1841,4839,512,1,8667,75,31,410,0,516,257,189,30,5,481,106,399,505,0,16,3,6,25,11934,169955,Whittlesea (C),2012,5632521
27070,3,1052,148,21,63,9,353,139,1785,109,1403,1465,4491,868,0,8336,87,102,418,2,609,295,193,58,1,547,107,855,962,0,7,3,9,19,12258,179080,Whittlesea (C),2013,5733545
27070,5,1121,222,25,56,5,456,130,2020,96,1314,1461,5544,1349,0,9764,95,55,483,2,635,358,184,49,5,596,135,1137,1272,0,7,8,7,22,14309,186843,Whittlesea (C),2014,5838110
27070,3,1130,271,18,102,7,459,159,2146,91,1223,1386,4967,1023,3,8693,128,80,625,0,833,382,180,47,0,609,141,1282,1423,0,14,12,5,31,13735,195397,Whittlesea (C),2015,5937481
27070,7,1167,243,25,65,10,501,176,2194,107,1307,1879,6478,971,0,10742,185,64,699,0,948,414,216,56,8,694,408,1470,1878,0,6,15,4,25,16481,200894,Whittlesea (C),2016,6053355
27170,3,298,76,4,7,0,55,29,469,47,505,348,1077,169,0,2146,35,7,109,1,152,108,141,45,0,294,73,185,258,0,0,4,6,10,3329,36576,Wodonga (RC),2012,5632521
27170,0,298,93,5,9,1,55,26,487,47,459,333,892,74,2,1807,30,15,109,0,154,71,90,22,0,183,40,171,211,0,2,0,2,4,2846,37307,Wodonga (RC),2013,5733545
27170,3,396,122,10,4,3,89,50,674,52,436,283,746,97,0,1614,35,9,122,0,166,100,117,36,1,254,81,394,475,0,2,7,1,10,3193,38067,Wodonga (RC),2014,5838110
27170,4,364,175,4,13,1,140,56,757,52,371,327,818,132,0,1700,18,9,108,0,135,116,104,40,0,260,113,544,657,1,1,3,6,11,3520,38559,Wodonga (RC),2015,5937481
27170,0,375,146,5,6,0,98,61,691,50,395,270,850,194,0,1759,40,13,160,0,213,98,94,25,1,218,114,401,515,1,0,3,2,6,3402,39439,Wodonga (RC),2016,6053355
27260,6,833,181,32,73,4,185,90,1404,102,1449,2200,5446,534,0,9731,89,68,402,0,559,286,256,144,1,687,113,407,520,0,8,10,4,22,12923,178859,Wyndham (C),2012,5632521
27260,3,1157,181,20,85,4,190,111,1748,124,1351,1527,4768,878,0,8648,120,62,325,0,507,298,274,61,1,634,132,652,784,1,5,26,13,45,12366,189063,Wyndham (C),2013,5733545
27260,7,994,188,18,96,7,248,125,1683,113,1277,1597,4987,956,1,8931,100,56,333,0,489,382,270,71,0,723,105,1071,1176,0,8,165,13,186,13188,199645,Wyndham (C),2014,5838110
27260,12,1038,185,23,114,6,303,148,1829,99,1075,1832,5321,904,1,9232,84,36,429,0,549,466,242,90,0,798,219,1137,1356,1,9,38,4,52,13816,209847,Wyndham (C),2015,5937481
27260,6,1161,247,25,127,7,331,170,2074,148,1200,1977,6057,804,0,10186,99,47,521,0,667,365,265,107,2,739,339,1753,2092,0,13,9,4,26,15784,218553,Wyndham (C),2016,6053355
27350,3,667,120,13,173,4,102,61,1140,37,1063,1134,4505,640,60,7439,208,9,667,1,885,234,807,43,4,1088,86,181,267,0,12,39,28,79,10898,80987,Yarra (C),2012,5632521
27350,7,780,103,14,135,3,121,53,1216,54,1017,1136,4160,847,0,7214,117,23,653,0,793,262,881,40,1,1184,138,229,367,1,14,48,8,71,10845,83508,Yarra (C),2013,5733545
27350,3,642,166,8,103,3,128,50,1100,17,1011,1204,4890,1285,0,8407,202,24,873,0,1099,439,854,38,1,1332,205,538,743,3,9,88,6,106,12787,86377,Yarra (C),2014,5838110
27350,0,751,165,17,89,6,143,61,1232,22,924,1213,5046,1180,0,8385,174,28,759,0,961,361,716,46,3,1126,124,770,894,0,9,12,10,31,12629,89151,Yarra (C),2015,5937481
27350,5,812,163,23,106,1,203,61,1374,24,1014,1326,5983,1587,0,9934,145,32,702,0,879,360,553,53,0,966,168,929,1097,0,13,17,1,31,14281,92225,Yarra (C),2016,6053355
27450,4,537,207,6,44,5,101,70,974,91,969,764,2049,324,0,4197,58,36,246,7,347,155,211,52,0,418,100,259,359,0,29,17,8,54,6349,149235,Yarra Ranges (S),2012,5632521
27450,3,630,238,7,30,2,134,83,1124,100,897,761,1769,327,0,3854,47,27,284,0,358,167,222,69,1,459,85,396,481,0,6,6,6,18,6294,149390,Yarra Ranges (S),2013,5733545
27450,7,704,242,12,34,2,171,85,1257,83,911,692,2247,552,0,4485,63,35,335,0,433,259,228,63,1,551,93,493,586,0,10,8,14,32,7344,150036,Yarra Ranges (S),2014,5838110
27450,6,622,265,5,28,2,236,63,1227,77,882,556,2096,611,0,4222,76,60,361,0,497,261,246,48,1,556,106,792,898,0,15,13,10,38,7438,150661,Yarra Ranges (S),2015,5937481
27450,6,759,312,18,24,4,255,104,1482,143,862,698,2602,420,0,4725,95,41,549,1,686,409,214,61,0,684,175,1084,1259,0,17,8,1,26,8862,150939,Yarra Ranges (S),2016,6053355
27630,0,42,17,0,0,1,16,2,78,1,67,25,105,20,0,218,4,0,11,0,15,21,44,8,0,73,3,15,18,0,2,3,1,6,408,7102,Yarriambiack (S),2012,5632521
27630,0,40,6,0,0,0,6,9,61,2,39,28,57,39,0,165,1,5,15,0,21,10,23,1,0,34,12,20,32,0,0,0,3,3,316,7021,Yarriambiack (S),2013,5733545
27630,0,56,19,1,0,0,5,0,81,2,23,20,45,3,0,93,4,18,6,0,28,35,29,2,0,66,5,28,33,0,0,1,0,1,302,6884,Yarriambiack (S),2014,5838110
27630,0,53,21,0,1,0,9,4,88,2,48,57,76,18,0,201,6,2,11,0,19,51,10,16,0,77,15,27,42,0,1,18,1,20,447,6759,Yarriambiack (S),2015,5937481
27630,0,76,27,0,1,0,21,2,127,9,63,39,83,17,0,211,2,6,10,0,18,16,19,12,0,47,10,57,67,0,1,1,1,3,473,6674,Yarriambiack (S),2016,6053355
